40 15
48 16
........................................
........................................
........................................
........................................
........................................
........................................
........................................
..............E.........................
.............E..........................
.......XXX..............................
....GGGGGGGGGGGGG.......................
GGGGGGGGGGGGGGGGG.......................
GGGGGGGGGGGGGGGGG.......................
GGGGGGGGGGGGGGGGG.......................
.....G..................................
