@SIZE 40 15
@SPAWN 1 5
@TILE_ROWS
........................................
.....E...E..............................
........................................
.....GGGGG.E..E.........................
........................................
........................E...............
...........GGGG...E.....................
..................GGGG..#...............
........................................
........................................
.......H.H........GGGGGGGGGGGGGGGGGGGGGG
....GGGGGGGGGGGGGGGGGGGGGGGGGGGGGGGGGGGG
GGGGGGGGGGGGGGGGGGGGGGGGGGGGGGGGGGGGGGGG
GGGGGGGGGGGGGGGGGG#GGGGGGGGGGGGGGGGGGGGG
GGGGGGGGGGGGGGGGGG#GGGGGGGGGGGGGGGGGGGGG
@TILE_ROWS
@END_TILE_ROWS
