@SIZE 40 15
@SPAWN 48 368
@TILE_ROWS
........................................
........................................
........................................
........................................
........................................
........................................
........................................
........................................
........................................
........................................
........................................
...H....E.EEEEEE........................
##################......................
#################.......................
........................................
@TILE_ROWS
@END_TILE_ROWS
